     #####    ##         ###   ###                       ##### /    ##   ###                         ###         ##    
  ######  /  #### /       ###   ###                   ######  /  #####    ###                         ###         ##   
 /#   /  /   ####/         ##    ##                  /#   /  /     #####   ###                         ##         ##   
/    /  /    # #           ##    ##                 /    /  ##     # ##      ##                        ##         ##   
    /  /     #             ##    ##                     /  ###     #         ##                        ##         ##   
   ## ##     #      /##    ##    ##      /###          ##   ##     #         ##    /###   ###  /###    ##     ### ##   










