           _                                   _                                               
          ' )     )           /' /'           ' )       )      )                    /'       /'
          /'    /'          /' /'              /      _/      /                   /'       /'  
       ,/'    /' ____     /' /' ____          /    _/~/    _/~____     ____     /' _____,/'    
      /`---,/' /'    )  /' /' /'    )--      /  _/~  /  _/~ /'    )--)'    )--/' /'    /'      
    /'    /' /(___,/' /' /' /'    /'        /_/~    /_/~  /'    /' /'       /' /'    /'        
(,/'     (_,(________(__(__(___,/'         /~      /~    (___,/' /'        (__(___,/(__   